                                                  
  ▩ ▩ ▩ ▩ ▩ ▩ ▩ ▩ ▩ ▩ ▩ ▩ ▩ ▩ ▩ ▩ ▩ ▩ ▩ ▩ ▩ ▩ ▩   
  ▩                     ▩                     ▩   
  ▩   ▩ ▩ ▩ ▩ ▩ ▩ ▩ ▩   ▩   ▩ ▩ ▩ ▩ ▩ ▩ ▩ ▩   ▩   
  ▩   ▩ ▩ ▩ ▩ ▩ ▩ ▩ ▩   ▩   ▩ ▩ ▩ ▩ ▩ ▩ ▩ ▩   ▩   
  ▩   ▩ ▩           ▩   ▩   ▩           ▩ ▩   ▩   
  ▩   ▩ ▩   ▩ ▩ ▩   ▩   ▩   ▩   ▩ ▩ ▩   ▩ ▩   ▩   
  ▩   ▩ ▩   ▩ ▩ ▩   ▩   ▩   ▩   ▩ ▩ ▩   ▩ ▩   ▩   
  ▩   ▩ ▩   ▩ ▩ ▩   ▩   ▩   ▩   ▩ ▩ ▩   ▩ ▩   ▩   
  ▩   ▩ ▩                               ▩ ▩   ▩   
  ▩   ▩ ▩ ▩ ▩ ▩ ▩   ▩   ▩   ▩   ▩ ▩ ▩ ▩ ▩ ▩   ▩   
  ▩                                           ▩   
  ▩ ▩ ▩ ▩ ▩ ▩ ▩ ▩   ▩   ▩   ▩   ▩ ▩ ▩ ▩ ▩ ▩ ▩ ▩   
  ▩                                           ▩   
  ▩   ▩ ▩ ▩ ▩ ▩ ▩   ▩   ▩   ▩   ▩ ▩ ▩ ▩ ▩ ▩   ▩   
  ▩   ▩ ▩                               ▩ ▩   ▩   
  ▩   ▩ ▩   ▩ ▩ ▩   ▩   ▩   ▩   ▩ ▩ ▩   ▩ ▩   ▩   
  ▩   ▩ ▩   ▩ ▩ ▩   ▩   ▩   ▩   ▩ ▩ ▩   ▩ ▩   ▩   
  ▩   ▩ ▩   ▩ ▩ ▩   ▩   ▩   ▩   ▩ ▩ ▩   ▩ ▩   ▩   
  ▩   ▩ ▩           ▩   ▩   ▩           ▩ ▩   ▩   
  ▩   ▩ ▩ ▩ ▩ ▩ ▩ ▩ ▩   ▩   ▩ ▩ ▩ ▩ ▩ ▩ ▩ ▩   ▩   
  ▩   ▩ ▩ ▩ ▩ ▩ ▩ ▩ ▩   ▩   ▩ ▩ ▩ ▩ ▩ ▩ ▩ ▩   ▩   
  ▩                     ▩                     ▩   
  ▩ ▩ ▩ ▩ ▩ ▩ ▩ ▩ ▩ ▩ ▩ ▩ ▩ ▩ ▩ ▩ ▩ ▩ ▩ ▩ ▩ ▩ ▩   
                                                  
